{
  "width": 10,
  "height": 10,
  "start": [0, 0],
  "end": [9, 9],
  "tiles": [
    ["S", "0", "0", "0", "W", "0", "0", "T", "0", "E"],
    ["W", "W", "W", "0", "W", "W", "0", "W", "W", "W"],
    ["0", "0", "0", "M", "0", "0", "0", "0", "0", "0"],
    ["0", "W", "W", "W", "0", "W", "W", "W", "W", "0"],
    ["0", "0", "0", "0", "0", "0", "0", "0", "0", "0"],
    ["0", "W", "0", "W", "0", "W", "0", "W", "0", "0"],
    ["0", "W", "0", "W", "0", "W", "0", "W", "W", "0"],
    ["0", "W", "0", "0", "0", "0", "0", "0", "0", "0"],
    ["0", "W", "W", "W", "W", "W", "W", "W", "W", "0"],
    ["0", "0", "0", "0", "0", "0", "0", "0", "0", "0"]
  ]
}
